WWWWWWWWWWWWW
W           W
W RRRRRRRRRWW
W           W
W RRWWW     W
W W   R     W
W WWWWWWW   W
W           W
W    R      W
W RRR       W
W R     W   W
W R   W     W
WWWWWWWWWWWWW