WWWWWWWWWWWWW
W           W
W WWWWWWWWWWW
W           W
W RRWWW     W
W W   R     W
W W R   R   W
W WWWWWWWWW W
W    R      W
W WWWWWWWWW W
W R W   W   W
W R         W
WWWWWWWWWWWWW